1111111111
10000A0001
1EPC111111
1111111111