111111111
10000E111
11P111111
110000111
111111111