11111111111
10000000001
1000C00C111
1E001111111
11111111111