1111111111
1EC0000011
11111P1111
1110000E11
1111111111