1111111111
1PC00010C1
1111100011
1111111111