1111111111
100000C001
1000CP1111
11E1111111
1111111011