1111111111
1P11111111
11111P1111
11EC000001
1111111111