111111111
10EP11111
111100001
1C0000001
100000001
111111111