111111
101P11
100011
1CE001
111111



