11111111
10000001
11000001
1CEP1111
11111111